NO ./north.xpm
SO ./south.xpm
WE ./west.xpm
EA ./east.xpm

F 220,100,0
C 225,30,0

11111111111111111111111111
1000000000110000000000001
1011000001110000000000001
100100000000000N000000001
1111111110110000011100001
10000000001100000111011111111111
11110111111111011100000010001
11110111111111011101010010001
11000000110101011100000010001
1000000000000001100000010001
10000000000000001101010010001
1100000111010101111101111000111
11110111 1110101 10111101011
11111111 1111111 111111111111
