NO textures/test/north.xpm
SO textures/test/south.xpm
WE textures/test/west.xpm
EA textures/test/east.xpm

F 20,20,20
C 200,200,200

1111111
1000001
1000S01
1000001
1000001
1000001
1100001
1000001
1000001
1000001
1000001
1000001
1111111




1